# width 8
# height 8

# spawnX 6
# spawnY 6

# nextLevel ../levels/map_1.txt

# mapWalls
1 1 1 1 1 1 1 1 
1 0 0 0 0 0 0 1 
1 0 1 1 0 1 1 1 
1 0 1 0 0 0 0 1 
1 0 1 0 0 0 0 1 
1 0 1 0 0 2 0 1 
1 0 1 0 0 0 0 1 
1 5 1 1 1 1 1 1 

# mapFloors
2 2 2 2 2 2 2 2 
2 1 1 1 1 1 1 2 
2 1 2 2 1 2 2 2 
2 1 2 3 3 3 3 2 
2 1 2 3 3 3 3 2 
2 1 2 3 3 3 3 2 
2 1 2 3 3 3 0 2 
2 2 2 2 2 2 2 2 

# mapCeilings
0 0 0 0 0 0 0 0 
0 0 0 0 0 0 0 0 
0 0 0 0 0 0 0 0 
0 0 0 0 0 0 0 0 
0 0 0 0 0 0 0 0 
0 0 0 0 0 0 0 0 
0 0 0 0 0 0 0 0 
0 0 0 0 0 0 0 0 
