# width 9
# height 9

# spawnX 4
# spawnY 7

# nextLevel ../levels/map_4.txt

# requirementsLenght 3
# requirements 5 7 10

# forbiddenLenght 3
# forbidden 6 8 9

# mapWalls
2 2 2 2 13 2 2 2 2 
2 0 0 0 0 0 0 0 2 
2 0 0 0 0 0 0 0 9 
2 0 0 0 0 0 0 0 2 
9 0 0 0 0 0 0 0 7 
2 0 0 0 0 0 0 0 2 
2 0 0 0 0 0 0 0 5 
2 0 0 0 0 0 0 0 2 
2 2 2 2 2 2 2 2 2 

# mapFloors
2 2 2 2 2 2 2 2 2 
2 2 2 2 14 2 2 2 2 
2 2 2 2 14 2 17 15 2 
2 2 2 2 14 2 14 2 2 
2 15 15 15 25 15 24 15 2 
2 2 2 2 2 2 14 2 2 
2 2 2 2 2 2 16 15 2 
2 2 2 2 2 2 2 2 2 
2 2 2 2 2 2 2 2 2 

# mapCeilings
4 4 4 4 4 4 4 4 4 
4 4 4 4 4 4 4 4 4 
4 4 4 4 4 4 4 4 4 
4 4 4 4 4 4 4 4 4 
4 4 4 4 4 4 4 4 4 
4 4 4 4 4 4 4 4 4 
4 4 4 4 4 4 4 4 4 
4 4 4 4 4 4 4 4 4 
4 4 4 4 4 4 4 4 4 
