# width 21
# height 21

# spawnX 10
# spawnY 18

# nextLevel ../levels/map_2.txt

# requirementsLenght 1
# requirements 6

# forbiddenLenght 1
# forbidden 5

# mapWalls
0 0 0 0 0 0 2 2 2 2 13 2 2 2 2 0 0 0 0 0 0 
0 0 0 0 0 0 2 0 0 0 0 0 0 0 2 0 0 0 0 0 0 
0 0 0 0 0 0 2 0 0 0 0 0 0 0 2 0 0 0 0 0 0 
0 0 0 0 0 0 2 0 0 0 0 0 0 0 2 0 0 0 0 0 0 
0 0 0 0 0 0 2 0 0 0 0 0 0 0 2 0 0 0 0 0 0 
0 0 0 0 0 0 2 0 0 0 0 0 0 0 2 0 0 0 0 0 0 
0 0 0 0 0 0 2 0 0 0 0 0 0 0 2 0 0 0 0 0 0 
0 0 0 0 0 0 2 0 0 0 0 0 0 0 2 0 0 0 0 0 0 
0 0 0 0 0 0 2 2 5 2 0 2 2 2 2 0 0 0 0 0 0 
0 0 0 0 0 0 2 2 2 2 11 2 2 2 2 0 0 0 0 0 0 
0 0 0 0 0 0 0 0 0 0 0 0 0 0 0 0 0 0 0 0 0 
0 0 0 0 0 0 0 0 0 0 0 0 0 0 0 0 0 0 0 0 0 
0 0 0 0 0 0 0 0 0 0 0 0 0 0 0 0 0 0 0 0 0 
0 0 0 0 0 0 0 0 0 0 0 0 0 0 0 0 0 0 0 0 0 
0 0 0 0 0 0 0 0 0 0 0 0 0 0 0 0 0 0 0 0 0 
0 0 0 0 0 0 0 0 0 0 0 0 0 0 0 0 0 0 0 0 0 
0 0 0 0 0 0 0 0 0 0 0 0 0 0 0 0 0 0 0 0 0 
0 0 0 0 0 0 0 0 0 0 0 0 0 0 0 0 0 0 0 0 0 
0 0 0 0 0 0 0 0 0 0 0 0 0 0 0 0 0 0 0 0 0 
0 0 0 0 0 0 0 0 0 0 0 0 0 0 0 0 0 0 0 0 0 
0 0 0 0 0 0 0 0 0 0 0 0 0 0 0 0 0 0 0 0 0 

# mapFloors
3 3 3 3 3 3 2 2 2 2 2 2 2 2 2 3 3 3 3 3 3 
3 3 3 3 3 3 2 2 2 2 14 2 2 2 2 3 3 3 3 3 3 
3 3 3 3 3 3 2 2 2 2 14 2 2 2 2 3 3 3 3 3 3 
3 3 3 3 3 3 2 2 17 15 19 2 2 2 2 3 3 3 3 3 3 
3 3 3 3 3 3 2 2 14 2 2 2 2 2 2 3 3 3 3 3 3 
3 3 3 3 3 3 2 2 14 2 2 2 2 2 2 3 3 3 3 3 3 
3 3 3 3 3 3 2 2 14 2 2 2 2 2 2 3 3 3 3 3 3 
3 3 3 3 3 3 2 2 14 2 2 2 2 2 2 3 3 3 3 3 3 
3 3 3 3 3 3 2 2 2 2 2 2 2 2 2 3 3 3 3 3 3 
3 3 3 3 3 3 2 2 2 2 2 2 2 2 2 3 3 3 3 3 3 
3 3 3 3 3 3 3 3 3 3 3 3 3 3 3 3 3 3 3 3 3 
3 3 3 3 3 3 3 3 3 3 3 3 3 3 3 3 3 3 3 3 3 
3 3 3 3 3 3 3 3 3 3 3 3 3 3 3 3 3 3 3 3 3 
3 3 3 3 3 3 3 3 3 3 3 3 3 3 3 3 3 3 3 3 3 
3 3 3 3 3 3 3 3 3 3 3 3 3 3 3 3 3 3 3 3 3 
3 3 3 3 3 3 3 3 3 3 3 3 3 3 3 3 3 3 3 3 3 
3 3 3 3 3 3 3 3 3 3 3 3 3 3 3 3 3 3 3 3 3 
3 3 3 3 3 3 3 3 3 3 3 3 3 3 3 3 3 3 3 3 3 
3 3 3 3 3 3 3 3 3 3 3 3 3 3 3 3 3 3 3 3 3 
3 3 3 3 3 3 3 3 3 3 3 3 3 3 3 3 3 3 3 3 3 
3 3 3 3 3 3 3 3 3 3 3 3 3 3 3 3 3 3 3 3 3 

# mapCeilings
0 0 0 0 0 0 0 4 4 4 4 4 4 4 0 0 0 0 0 0 0 
0 0 0 0 0 0 0 4 4 4 4 4 4 4 0 0 0 0 0 0 0 
0 0 0 0 0 0 0 4 4 4 4 4 4 4 0 0 0 0 0 0 0 
0 0 0 0 0 0 0 4 4 4 4 4 4 4 0 0 0 0 0 0 0 
0 0 0 0 0 0 0 4 4 4 4 4 4 4 0 0 0 0 0 0 0 
0 0 0 0 0 0 0 4 4 4 4 4 4 4 0 0 0 0 0 0 0 
0 0 0 0 0 0 0 4 4 4 4 4 4 4 0 0 0 0 0 0 0 
0 0 0 0 0 0 0 4 4 4 4 4 4 4 0 0 0 0 0 0 0 
0 0 0 0 0 0 0 4 4 4 4 4 4 4 0 0 0 0 0 0 0 
0 0 0 0 0 0 0 0 0 0 4 0 0 0 0 0 0 0 0 0 0 
0 0 0 0 0 0 0 0 0 0 0 0 0 0 0 0 0 0 0 0 0 
0 0 0 0 0 0 0 0 0 0 0 0 0 0 0 0 0 0 0 0 0 
0 0 0 0 0 0 0 0 0 0 0 0 0 0 0 0 0 0 0 0 0 
0 0 0 0 0 0 0 0 0 0 0 0 0 0 0 0 0 0 0 0 0 
0 0 0 0 0 0 0 0 0 0 0 0 0 0 0 0 0 0 0 0 0 
0 0 0 0 0 0 0 0 0 0 0 0 0 0 0 0 0 0 0 0 0 
0 0 0 0 0 0 0 0 0 0 0 0 0 0 0 0 0 0 0 0 0 
0 0 0 0 0 0 0 0 0 0 0 0 0 0 0 0 0 0 0 0 0 
0 0 0 0 0 0 0 0 0 0 0 0 0 0 0 0 0 0 0 0 0 
0 0 0 0 0 0 0 0 0 0 0 0 0 0 0 0 0 0 0 0 0 
0 0 0 0 0 0 0 0 0 0 0 0 0 0 0 0 0 0 0 0 0 
